00000000000000000000
01111111111111110000
00010000001000000000
00010111111111000000
00010000010100000000
00010000010111100000
01111110010000100000
00000000010001111110
00000000010000000000
01111111111111110000
00010000001000000000
00010111111111000000
00010000010100000000
00010000010111100000
01111110010000100000
00000000010001111110
00000000010000000000
00000000000000000000
-