00000000000000000000
01111111111111110000
00010000001000000000
00010111111111000000
00010000010100000000
00010000010111100000
01111110010000100000
00000000010001111110
00000000010000000000
00000000000000000000
-
00000000000000000000
01111111111000000000
00000100001000000000
00001100011110000000
00011000010000111000
00010000011111100000
01110000010000100000
00000000010011111110
00000000010000000000
00000000000000000000
-
00000000000000000000
01000000000000000000
01000111110000000000
01001100011110000000
01011000010000000000
01010000111111100000
01110000010000100000
00000000010011111110
00000011110000000000
00000000000000000000